12,7
10
50
8,2,MALE
2,3,FEMALE
3,3,FEMALE
GGGGGGGGGGGG
GTTPPPTTPPPG
GGGGGPGGPGPG
GGGPPPGGPGPG
GGGGGPGGPGPG
GTTPPPTTPPPG
GGGGGGGGGGGG
