18,7
10
50
GGGGGGGGGGGGGGGGGG
GTTPPPTTPPPTTPPPPG
GPGGGPGGPGPGGPGGTG
GPGPPPGGPGPTTPPPPG 
GPGGGPGGPGPGGPGGTG
GTTPPPTTPPPTTPPPTG
GGGGGGGGGGGGGGGGGG
