15,7
10
50
GGGGGGGGGGGGGGG
GPPPTTPPPGGPPTG
GGGPGGGGPPPPGTG
GPPPGGPPPGGPGTG 
GPGGTTGGPTTPGPG
GPPPPPPPPGGPPPG
GGGGGGGGGGGGGGG
