15,7
GGGGGGGGGGGGGGG
GPPPTTPPPTTPPTG
GGGPTTGGPGGPGTG
GPPPTTPPPGGPGTG 
GPGGTTGGPGGPGPG
GPPPPPPPPTTPPPG
GGGGGGGGGGGGGGG