11, 7
GGGGGGGGGGG
GTTPPPTTPPG
GPGGGPGGPGG
GPGPPPTPPPG
GPGGGPGPPGG
GTPPPPGTPPG
GGGGGGGGGGG
120
8, 1;1, 3;9, 5
25
12