12, 7
GGGGGGGGGGGG
GTTPPPTTPPPG
GGGGGPGGPGPG
GGGPPPGGPGPG
GGGGGPGGPGPG
GTTPPPTTPPPG
GGGGGGGGGGGG
100
5, 1;5, 3;5, 5
50
10