10, 5
GGGGGGGGGG
GTTPPPTTPG
GPGGGPGGPG
GPTPPPGGPG
GGGGGGGGGG
100
4, 3;7, 1;5, 3
10
10