18,7
GGGGGGGGGGGGGGGGGG
GTTPPPTTPPPTTPPPPG
GPGGGPGGPGPGGPGGTG
GPGPPPGGPGPTTPPPPG 
GPGGGPGGPGPGGPGGTG
GTTPPPTTPPPTTPPPTG
GGGGGGGGGGGGGGGGGG