12, 7
GGGGGGGGGGGG
GPPPTTPPPTTG
GGGPTTGGPGGG
GPPPTTPPPGGG
GPGGTTGGPGGG
GPPPPPPPPTTG
GGGGGGGGGGGG
90
1, 1;6, 5;10, 5;9, 1;1, 4;8, 4
30
12